# Види тиші

br - дихання
pau - пауза
sil - довга пауза
cl - гортанна змичка / витримка між приголосними фонемами

# Голосні

y - и
i - і
e - е
a - а
o - о
u - у

#Тверді приголосні
m - м
v - в
p - п
b - б
f - ф

d - д
t - т
z - з
s - с
c - ц
l - л
n - н
r - р
dz - дз

dzh - дж
ch - ч
zh - ж
sh - ш

g - ґ
k - к
x - х

h - г

# М'які та пом'якшені приголосні

j - й

dj - дь
tj - ть
zj - зь
sj - сь
cj - ць
lj - ль
nj - нь
rj - рь
dzj - дзь

mj - мь
vj - вь
pj - пь
bj - бь
fj - фь

kj - кь
gj - ґь

hj - гь

dzhj - джь

# Алофони

E - ненаголошена е/и
W - ў (нескладова)
Y - нескладова і
O - неналогошена о перед складом з наголошеною у або і
